#################....................................................................#################
#################....................................................................#################
#################....................................................................#################
#################....................................................................#################
#################....................................................................#################
#################....................................................................#################
#################....................................................................#################
#################....................................................................#################
#################....................................................................#################
#################....................................................................#################
#################....................##.................#............................#################
#################......##..........#####.............#..#............................#################
#################S....####........#######........#...#..#...........................E#################
####################################################.#..#..########...#..###..########################
####################################################.#..#..########...#..###..########################
####################################################.#..#..########...#..###..########################
####################################################.#..#..########...#..###..########################
####################################################.#..#..########...#..###..########################
####################################################.#..#..########...#..###..########################
####################################################.#..#..########...#..###..########################
####################################################.#..#..########...#..###..########################
####################################################.#..#..########...#..###..########################
####################################################.#..#..########...#..###..########################
####################################################^#^^#^^########^^^#^^###^^########################
######################################################################################################