..............................#.#.....
...........#..................#.#.....
..........###.................#.#.....
....<.>...().......#.........#........
.....v....q................####.###...
.......`......S..#..^.^.^.{....-#.....
################X#####################